                   ############
                   #..........#
                   #.########+#
                   #.#      #.#
                   #.#      #.#
      ##############+#      #.#
      #.............##      #.#
      #.............#       #+#
      #.............#       #.########        ##################
      #.............#       #........#        #...............>#
      #.............#       ########.#        #................#
      #.............#            ###.#        #................#
      #######+#######       ######...#        #................#
            #.#             #........#        #................#
            #.#             #........#        #................#
            #.#             #.########        #................#
            #.#             #.#               #................#
            #.#             #.#               #................#
#############.#             #.#               #................#
#...........+.#             #.#               #................#
###############             #.#################................#
                            #...............+..................#
                            ####################################






