                                                                     #######################
                                                                     #.....................#
                                                                     #...##############....#
                                                                     #...#####>..#    #....#
                                                                     #...#######.#    #....#
                                                                     #...........#    #....#
                                                                     #############    #....#
                                                                                      #....#
                                                                                      #....#
                                                                                      ##.###
                                                                                       #.#
                                                                                       #.#
                                                                                       #.#
                                                                                       #.#
                                                                                       #.#
                                                                                       #.#
                                                                        ################+#####
                                                                        #..........+.........#
                                                                        #.##########.........#
                                                                        #.#        #.........###
                                                                        #.#        #.........+.#
                                                                        #.#        ###########.#
                                                                        #.#                  #.#
                                                                  #######+####              ##.#
                                                                  #..........#              #..#
                                                                  #..........#              #.##
                                                                  #..........#              #.#
                                                                  #######+###################+#######
                ###################################################.................#...............#
                #........................#....#....#....#....#....#.................#...............#
                #...#..................#.#....#....#....#....#....#.................#...............#
                #...#..................#.#..###..###..###..###..###.................#...............#
                #...####################..........................####+##########+#####.............#
                #.............#        #.###..###..###..###..####.#....#..............#.............#
                #.............#        #.#....#....#....#....#..#.#....#..............#+##..........#
                ####+##########        #.#....#....#....#....#..#.#....#.................#..........#
                   #.#                 ##########################+######.................#..........#
                   #.#                 #.#....#....#....#....#....##...+.................#..........#
####################.#                 #.#....#....#....#....#....##.# #.................#..........#
#......+.............#                 #.#..###..###..###..###....##.# ##############################
#......#############.#                 #..........................+..# #..+.....#...................#
#......#           #+##########        #.###..###..###..###..####.#### #..#.....#...................#
#......#           #..........#        #.#....#....#....#....#..#.#    #..#.........................#
#+#....#           #..........#        #.#....#....#....#....#..#.#    #..#############+#############
#.#....#           #..........#        #+##########################    #..#           #........#....#
#.##...#           #..........#        #.#....#....#....#....#....#    #..#           #........#....#
#..#...#           #..........#        #.#....#....#....#....#....#    #..#           ####.....#....#
########           #..........#        #.#..###..###..###..###....#    #..#           #..+.....+....#
                   #+##########        #..........................#    #..#           ###############
                   #.#                 #.###..###..###..###..####.#    #..#
                   #+###############   #.#....#....#....#....#..#.#    #..#
                   #............+..### #.#....#....#....#....#..#.######++#
     ..............+............###..############################+#.......#
     ..............+............# ###..+...........#......................#
                   ##############   ####..................................#
                                       ####################################
