##########
#........#
#........#
#...@....#########
#................****
#.######.#########  *
#........#          *
#........#          *
#........#          *
##########          *
             #######*######
             #............#
             ##########..>#
                      #####
