                                                                     #######################
                                                                     #.....................#
                                                                     #...##############....#
                                                                     #...#####>..#    #....#
                                                                     #...#######.#    #....#
                                                                     #...........#    #....#
                                                                     #############    #....#
                                                                                      #....#
                                                                                      #....#
                                                                                      ##.###
                                                                                        *
                                                                                        *
                                                                                        *
                                                                                        *
                                                                                        *
                                                                                        *
                                                                                   #####+#####
                                                                         **********+.........#
                                                                         *         #.........#
                                                                         *         #.........#
                                                                         *         #.........+*
                                                                         *         ###########*
                                                                         *                    *
                                                                  #######+####                *
                                                                  #..........#               **
                                                                  #..........#               *
                                                                  #..........#               *
                                                                  #######+###################+#######
                ###################################################.................#...............#
                #........................#....#....#....#....#....#.................#...............#
                #...#..................#.#....#....#....#....#....#.................#...............#
                #...#..................#.#..###..###..###..###..###.................#...............#
                #...####################..........................####+##########+#####.............#
                #.............#        #.###..###..###..###..####.#....#..............#.............#
                #.............#        #.#....#....#....#....#..#.#....#..............#+##..........#
                ####+##########        #.#....#....#....#....#..#.#....#.................#..........#
                    *                  ##########################+######.................#..........#
                    *                  #.#....#....#....#....#....# ***+.................#..........#
########            *                  #.#....#....#....#....#....# *  #.................#..........#
#......+*************                  #.#..###..###..###..###....# *  ##############################
#......#            *                  #..........................+**  #..+.....#...................#
#......#           #+##########        #.###..###..###..###..####.#    #..#.....#...................#
#......#           #..........#        #.#....#....#....#....#..#.#    #..#.........................#
#+#....#           #..........#        #.#....#....#....#....#..#.#    #..#############+#############
#.#....#           #..........#        #+##########################    #..#           #........#....#
#.##...#           #..........#        #.#....#....#....#....#....#    #..#           #........#....#
#..#...#           #..........#        #.#....#....#....#....#....#    #..#           ####.....#....#
########           #..........#        #.#..###..###..###..###....#    #..#           #..+.....+....#
                   #+##########        #..........................#    #..#           ###############
                    *                  #.###..###..###..###..####.#    #..#
                   #+############      #.#....#....#....#....#..#.#    #..#
                   #............+**    #.#....#....#....#....#..#.######++#
     **************+............#  **  ##########################+#.......#
     **************+............#    **+...........#......................#
                   ##############      #..................................#
                                       ####################################
