##########
#........#
#........#
#...@....#########
#................+***
#.######.#########  *
#........#          *
#........#          *
#........#          *
##########          *
             #######+######
             #............#
             ##########..>#
                      #####
