           ###########################################################
           #..#...........#...........#........#..............#..#...#
           #..#..#######..#..####..#######..####..####..####..#..+...#
           #...........#.....#..#........#........#..#..#.....#..#...#
           #######..#..#######..#######..#..#..#..#..#..#######..#####
           #.....#..#...........#........#..#..#..#..#........#..#
           #..#..##########..#..#..#######..####..#..#######..#..#
           #..#...........#..#..#.....#........#........#.....#..#
           #..##########..####..####..#..####..#######..#..####..#
           #........#........#.....#..#.....#........#..#........#
          ##........####..#..####..#..#######..#..#..#..##########
          #............#..#........#...........#..#..#...........#
          #.........#######.....################################.#
          ##........################                           #.#
     #######........#########......###       ###################.########
     #...............#...............##      #..........................#
    ##...............#................##     #.##########################
######.............#########...........##    #.#     #...##...#####....#
#>.................#######..............#    #.#     ##.......#.###.#..##
######.............#######..............#    #.#      #..#..###.....#...#
    ##...........######....##..######...#    #.#      ##.........######.#
     ###################...##..#    ##..######.#       ####.#...###....##
                     #........####   ##........#        ###...#.###.####
                     #######..##.#    ##########         ###..#...##.#
                         ###..##.##        ##..##         ##....####.#
                         #...###..##    ####...##          ##...###.##
                         #...###...#  ####...#.##           ##...###.#
                         #...#.#...# ##.....##..##           ##..##.###
                         #...#.....###...........##############...##..#
                         #........................................#.#.#
              #####################################################.#.###
              #........#..#........#........#.....#..#.....#............####
              #..####..#..#######..####..#..####..####..##########.........##
              #..#.....#........#........#.....#..#..............#.....#..##
              #..#..#######..#..####..#######..#..#..##########..#...######
              #..#........#..#..#.....#........#...........#..#.....#
              #..#######..#..#..#..####..#######..#######..#..#######
              #..#.....#..#..#........#........#..#.....#...........#
               #.#..####..####..####..#######..####..#..#######..#..#
               #.#..............#........#...........#...........#..#
               #.####################################################
              ##+##
              #...#
              #...#
              #####
