                               ##########
                               #........#
                               #........#
                               #........#
                               #...######
                               #...#
                               #...#
                               #...#
                               #...#
                               #...######
                               #........+*
                               #####+#### ****
                                    *        *
                                    *        *
                                    *         ******
                                    *              *********
                                    *                      *
  ##########                  ######+######           #####+######
  #........#                  #...........#           #..........#
  #........#                  #...........#           #..........#
  #........#########          #...........+***********+..........#
  #................+**********+...........#   *       #..........#
  #.######.#########  *       #############   *       #####......############
  #........#          *                       *           #.................#
  #........#          *                       *           #.................#
  #........#          *                       *           ###################
  ##########          *              #########+#
               #######+######        #.........##########
               #............#        #.........+........#
               ##########..>#        #.........#........#
                        #####        #.........#........#
                                     ###########........#
                                               ##########
