#####################
#...................#
#.........#########.#
#.........#.........#
#.........#.....@...#
#.........#.........#
#.....###############
#...............#
#...............#           ############
#...............*************..........#
#...............#           #.....>....#
#################           ############
