#####################
#...................#
#.........#########.#
#.........#.........#
#.........#.........#
#.........#.........#
#.....###############
#...............#
#...............#           ############
#...............+***********+..........#
#...............#           #.....>....#
#################           ############
