################
#..@...........#
#######..#######
#..............#
##############*#
              *
              *
##############*#
#..............#
#######..#######
#..............#
#*##############
 *
 *
#*##############
#..............#
#######..#######
#..........>...#
################
