################
#..@...........#
#######..#######
#..............#
##############+#
              *
              *
##############+#
#..............#
#######..#######
#..............#
#+##############
 *
 *
#+##############
#..............#
#######..#######
#..........>...#
################
