


                 ____     ____     ____    __  __
                |  _ \   / __ \   / __ \  |  \/  |
                | |_) | | |  | | | |  | | | \  / |
                |  _ <  | |  | | | |  | | | |\/| |
                | |_) | | |__| | | |__| | | |  | |
                |____/   \____/   \____/  |_|  |_|

