


             _____  _____              _____  _    _
            / ____||  __ \     /\     / ____|| |  | |
           | |     | |__) |   /  \   | (___  | |__| |
           | |     |  _  /   / /\ \   \___ \ |  __  |
           | |____ | | \ \  / ____ \  ____) || |  | |
            \_____||_|  \_\/_/    \_\|_____/ |_|  |_|
